NO ../maps/eren.xpm
SO ./path_to_the_south_texture
WE ./path_to_the_west_texture
EA ./path_to_the_east_texture

C 103,193,202
F 177,179,178

111111
100101
101001
1100N1
111111